#############
#          B#
# ######### #
# #       # #
# # ##### # #
#    #    # #
#### # #### #
#A   #      #
#############