#########
#A#   # #
# # # # #
# # #   #
#   ### #
#     #B#
#########