###########
#A#     #B#
# # # # # #
# #     # #
#   ###   #
#         #
###########